XXXXXXXXXX
XXXXXXXXXX
XXXXXXOXXX
XPOXXGBOXX
XOOXXXOOOX
XOBOOOOBOX
XXGXXXXGXX
XXXXXXXXXX
XXXXXXXXXX
XXXXXXXXXX
