XXXXXXXXXX
XXXXXXXXXX
XXXXXXOXXX
XPOXXOOOXX
XOBXXXOOOX
XOBOOOOOOX
XXOXXXXOXX
XXXXXXXXXX
XXXXXXXXXX
XXXXXXXXXX
