XXXXXXXXXX
XXXXXXXXXX
XXXXXXOXXX
XPOXXOOOXX
XOOXXXOOOX
XOOOOOOOOX
XXOXXXXOXX
XXXXXXXXXX
XXXXXXXXXX
XXXXXXXXXX
