XXXXXXXXXX
XPBOOGXXXX
XOXXXXXXXX
XOOOOOBGXX
XBXOXXXXXX
XGXOOOGXXX
XXXOOBBXXX
XXXOOOBXXX
XXXXOOOXXX
XXXXXXXXXX
